
 Sebastian Moreno P al correo : lazulibeach@gmail.com del folio qETwBZLbPh
 ERNESTO AVENDA al correo : rayavemal@gmail.com del folio IfQswNm0Ka
 ERNESTO AVENDA al correo : rayavemal@gmail.com del folio IfQswNm0Ka
 Cesar Sanchez Sanchez al correo : xocoyotess@hotmail.com del folio sqxfNkQ08n
 ESTELA YANYT PABLO CRUZ al correo : estelayanyt@hotmail.com del folio fBWdvwloxP
 Francisco Javier Torres Hern al correo : fjth070767@gmail.com del folio 56AvDMUJXm
 Luis Armando Ziga Fakardo al correo : naaiiee_@hotmail.com del folio hECyRIwQ50
 Nallely Ramirez Almaraz al correo : armandobadtrip@gmail.com del folio 7EyItslTYc
 Rosalva Francisco Mejia al correo : mujeresalfareras_tlahuac@yahoo del folio VvufxMa4yj
 JAVIER BAUTISTA HERNANDEZ al correo : pepeisa@live.com.mx del folio mTbgBerU9Z
 Efraìn Caballero Sànchez al correo : artebajolaciudad@yahoo.com.mx del folio UvGNeby5xR
 vega vargas fabiola citlalli al correo : plataxitla@gmail.com del folio DTrtonEwRb
 Maria Concepcion Cardenas Diaz al correo : alejandralca@gmail.com del folio ZMrwFHohf7
 Martha Gordillo Resend al correo : colectivotemixoch@gmail.com del folio ZYAEoeh7H6
 Jonathan Federico Leonardo al correo : rkm_atv@hotmail.com del folio VyoOX6rA5D
 Evodio Federico Isidro al correo : huapanguero58@hotmail.com del folio qXJCgmnF9S
 Aurora Plana Ignacio al correo : reposteriaelcamellito@hotmail. del folio dq1gStQwDu
 Oscar Filomeno Arellano Cortes al correo : ivett73@hotmail.com del folio CmyzZwHa4S
 SERGIO ALBERTO ORTEGA ALVAREZ al correo : albertoaoa@hotmail.com del folio ixckNl8a0B
 Porfirio Osvaldo Olivera Quero al correo : dcsr_10@hotmail.com del folio VZOxbhPmJF
 patricia Jimenez Sanches al correo : patyfandanguera1@hotmail.com del folio 7XlZ5PIqyA
 josè del carmen prieto de los monteros al correo : pdlm1633@hotmail.com del folio EuTtndOGAD
 Jose Luis Perez Delgado al correo : sombrerossantamaria@hotmail.co del folio O3PuAnJtEp
  al correo :  del folio UZCq8OKygz
 Susana  Millán  Cervantes al correo : sedamillan@hotmail.com del folio P3LJzrkdvw
  al correo :  del folio X9MzZRiAOY
  al correo :  del folio 1erjtRgWfC
 Samuel Tejeda Rm al correo : ichtlimaori@live.com.mx del folio d3V5pjR6Ao
  al correo :  del folio lTmct6WLpw
  al correo :  del folio hnVvyUH1ws
 EDUARDO VILLANUEVA OSORIO al correo : lalo-966@hotmail.com del folio zB3KL2udTh
 JUAN CARLOS CRUZ al correo : varovaromarakero@yahoo.com.mx del folio qpH64wMoZ5
 Leandra Cuahutencos al correo : metzeri_ropaartesanal@hotmail. del folio g3sKd65Lux
 Maria Evelia Hernandez Romero al correo : micafecito13@yahoo.com.mx del folio Xduj9bW6CF
 Juan Carlos Felipe Castillo al correo : orfebreria_itzi@hotmail.com del folio nNKjvsPlwG
 Mariana Juárez Jurado al correo : lachinampaixtacalco@gmail.com del folio Y5p30vGxAj
 javier bautista escalante al correo : javitobautista@gmail.com del folio bHaAspMxeD
 Cesar Montes Rosales al correo : copela_1@hotmail.com del folio jvtU5qmbc9
 julio david vilchis ramirez al correo : artesound123@hotmail.com del folio jAXthaUeC6
 Alicia Moreno Velazquez al correo : piojosypulgas@openmailbox.org del folio Pbz9E523QT
 Ismael Gonzalez Partida al correo : ismarlgonzalez210@yahoo.com.mx del folio tnyRflN2Xz
 JOSE ROSENDO SERVIN FERRUSCA al correo : rosendoplateado@gmail.com del folio nOGBQfCHty
 Alejandra Jimenez Cano Josue Garcia Garcia al correo :  del folio H7JymiczLd
 jorge Gómez Tavares al correo : jorgedandotelata@yahoo.com del folio oClTN2weU3
 Estela Pascual Granados al correo : stella101072@hotmail.com del folio y2WwdOgcN0
 CATALINA SOTOESTRADA al correo : zurdacreaciones@gmail.com del folio rgGuvt8V4H
 Martiano Velasco Hernández al correo : martinianobears@hotmail.com del folio zUHFc7JOSj
 Georgina Lomelí Ramírez al correo : rosadecastilla42@hotmail.com del folio AxXfRwFYSZ
 maría de lourdes montiel rivadeneyra al correo : ululconejo@yahoo.cpm.mx del folio w0R6dKTEXx
 Addis Abeba Riveros Aguirre al correo : dmelonosandia@gmail.com del folio n3E4t9l8qg
 Maria Alejandra Spindola Consuelo al correo : armandoartes@live.com.mx del folio hZV0onKUaO
 Gabriela Carrillo Garrido al correo : ketotextil@hotmail.com del folio QRDVFrqgOK
 Lourdes hernandez ortiz al correo : artesanias_lulu@hotmail.com del folio 2HlPcpmWET
 CELIA URBANO FLORES al correo : zeliaurbano@hotmail.com del folio rv3N1tBTFK
 AGUSTIN ESTANISLAO SOSA MENDEZ al correo : naylicsp39@hotmail.com del folio 7rdGAI951m
 sarai al correo : sajariguani@hotmail.com del folio rnQ1MphHXC
 Arturo Amador Sánchez al correo : aduart2001@hotmail.com del folio CE1en9L4N0
 Claudia Gabriela Vivas Villasana al correo : vivas_gaby@hotmail.com del folio F1svAoQhWz
 Rocio Elvia Jasso Aguilar al correo : tsocualli61@hotmail.com del folio 6CxPzXQrDo
 Adriana García Martínez al correo : cartonesa@gmail.com del folio D6WlkBHQJq
 MAIRA ARROYO al correo : mixantena@hotmail.com del folio 1PZbTEH27l
 MA DOLORES SANCHEZ NAJERA al correo : basaart@gmail.com del folio oY6pCRw87b
 Claudia Olvera Navarro al correo : caludiaolna@tahoo.com del folio QChzHcrB3F
 Maribel Canseco Mendez al correo : mar_psic6@hotmail.com.mx del folio GqPut532vE
 Paulino De Aquino Flores al correo : paulinodeaquinoflores@hotmail. del folio jK45r7fmNy
 Jose Fausto Morales Diaz al correo : fotosantiguas@outlook.com del folio aHIZyMb2N6
 Martha Guadalupe Martínez Crivelli al correo : tallerderepujado@yahoo.com.mx del folio it4Xkls3V8
 Mariana Perez Nahon al correo : emeitezetaygriega@hotmail.com del folio hPszSB8YXH
  al correo :  del folio C8Nus2YwM4
 Alma Rosa Millán Arciga al correo : kehmanik@gmail.com del folio IFtLnXC4Ad
 CHRISTIAN DIONICIO HERNANDEZ al correo : cristian.dionicio@yahoo.com.mx del folio Tia7RvuFl4
 BLANCA al correo : quehacerdecomer@hotmail.com del folio UJ5cGXCPdk
 Pina Vazquez al correo : cesar@nostalgiahuasteca.com del folio jiUgFGqmr2
  al correo :  del folio d8GeWrE0FB
 Rocio del Carmen Navarrete Consuelo al correo : xitsi.natural@gmail.com del folio KaR1fJEZsj
 Rocio del Carmen Navarrete Consuelo al correo : xitsi.natural@gmail.com del folio njQq50sedm
 Sara Garcia Lopez al correo : xtonalthe@gmail.com del folio pkRPVq3fwQ
 Juan Cuervo juarez y maria del refugio cuervo juarez al correo : cuervojuarezjuan@gmail.com del folio ajCSKgQX6Y
 Esthela Yalí Bravo Castillo al correo : duv.yali@gmail.com del folio iSDYvpU0jk
 Adriana Chiney Sanchez al correo : chineysita@hotmail.es del folio 3WimA6DpCw
 GUADALUPE JAVIER QUI al correo : mastlatoanitienda@hotmail.com del folio J5zlGUx4IK
 María Teresa Trujillo Vicente al correo : tallerdediseno@live.como.mx del folio klqjCYvQei
 Roxana Sarabia Páez al correo : sayarh@yahoo.es del folio mZ3IgbNSH0
 Eva areli Mancilla Peláez al correo : donpanchirri@gmail.com del folio wJjyHQ5rKY
 Gonzalo de Aquino Flores al correo : cafeiliatenco_gonzalo@hotmail. del folio ZveJQXlo51
 José Omar Bueno Domínguez al correo : joseomarbueno@gmail.com del folio gGPmEAjl6R
 Araceli Flores Camacho al correo : a_flores_camacho@hotmail.com del folio 9g7nFep1Yb
 Raúl Huanosta Vargas al correo : raullirahuanosta@gmail.com del folio oyicQNrBxD
 Carlos Alvarado Arguello al correo : kalartehua@hotmail.com del folio XSNHY8f07c
 Josue Garcia Garcia Alejandra Jimensz Cano al correo : nisiuatl@yahoo.com.mx del folio knGXrcxj3s
 Imelda Servin Morales al correo : imeservin@hotmail.com del folio o97JHgEdnZ
 Juan Arturo Hernández Ochoa al correo : revistahuasteca@hotmail.com del folio V9lcATC6NS
 Ricardo Hernández al correo : andreshdzotz@gmail.com del folio KRbc9ZWkQF
 Maria de Jesús Santana de la Rosa al correo : mariasantana33@hotmail.com del folio RadZpKIOsC
 Jascive Sánchez velasquez al correo : monacobanquetes@gmail.com del folio VCecls4Zby
 Leslie Joyarit Gómez Cisneros al correo : joyarit_1201@hotmail.com del folio J2YP7KTWtr
 Juan Gómez  Hernández al correo : rec_jhon@hotmail.com del folio D3GmHEfQOU
 KARINA JIM al correo : makkame_@hotmail.com del folio mIpHqgUGWJ
 Ernesto Avendaño Ramírez al correo : ream_00@hotmail.com del folio 3YZjp4gB2W
 Edilberto Arturo Castellanos Santiago al correo : edilbertoarturo@gmail.com del folio TJwXyM1E2i
 carlota gil sotp al correo : kalo_jayko@hotmail.com del folio vbkBlGaXEc
 Jaime Choque Mendoza al correo : jaime1866@yahoo.com.mx del folio bJNZQHupBt
 Leticia de la Rosa Beltrán al correo : leticiadelarosa@live.com.mx del folio fWPxnUKYjT
 Patricia Neri Heredia al correo : dquetzul@live.com.mx del folio o3aNcMzuvq
 Evelyn Quijano Benítez al correo : evelynquijano@rocketmail.com del folio RNh1q7BaXt
 lilia valencia duran al correo : viviendodetusojos@yahoo.com del folio krxew4dVWv
 Angelica Aguilar Montes al correo : angievidevil7@yahoo.com.mx del folio tAyi1bs9Jw
 francisco mendez alavez al correo : rosy_bata@hotmail.com del folio TLhe5XtVOr
 Jose Hernandez Luna al correo : josehl99@yahoo.com del folio kAbR3gjKZn
 rosa ma alvarez garcia al correo : vitra_arte@hotmail.com del folio a9MiYtO5wj
 Roberto Campos Hernandez al correo : artedenuestrospueblos@gmail.co del folio ScgQXhOY0R
 LINDA MARIA MACIAS PALMA al correo : linjosiempre@gmail.com del folio qJKOdcMbhX
 Luisa Rita Quezada Castro al correo : luisarita15@gmail.com del folio GcXZVQyUCS
 Severiano Guillermo Santiago de la Fuente al correo : guillermosantiago73@yahoo.com. del folio ajcfoZA38I
 Silvia Santos Leon al correo : elenithags5@gmail.com del folio sY3mX25b61
 Luis Ángel Venegas de la Rosa al correo : ouso_inside@hotmail.com del folio VFI2ycj8Ei
 Yolanda Ambrocio Torres al correo : yoyoirie_@hotmail.com del folio FRXICfaPeE
 Ninel itzel gonzalez moreno al correo : ninelitzel@gmail. Com del folio yr6PopJQac
 FERNANDO RODRIGUEZ DELGADO al correo : chocolatemacondo@hotmail.com del folio uFlpkmDMKN
 Mónica Alejandra Barajas Hernández al correo : arzolike@hotmail.com del folio PgGo3Spwrb
 Israel García White al correo : white0_4@hotmail.com del folio 2LBYrblTGf
 Rosa Felipa Juarez Laynez al correo : rosa_juarez_y_nicolas@hotmail. del folio tATUGK2zjH
 Victoria Lujano al correo : vi-k-lua@hotmail.com del folio Gr39KOASfD
 Nahomi tovar jimenez al correo : nahomi.tovar25@gmail.com del folio vCaFnM86b4
 Jose Guillermo Tovar Jimenez al correo : guillermotovar@live.com.mx del folio CRNVhDyM91
 Reyna Gonz al correo : artedelsurmexico@live.com del folio rDXGiwC0cy
 Gloriaydee Ruiz Castro al correo : arteenchaquiraventas@gmail.com del folio E9fuV57CUc
 Itzel Bueno al correo : itze.bupe@gmal.com del folio 8Joyr4BKdq
 Graciela Sosa Mendez al correo : carlos@charliegourmet.com del folio Li6AQYJwFo
 CARLOS EZEQUIEL SOSA MENDEZ al correo : seradack_crew@hotmail.com del folio 4GJ1jEozer
 Marcelino galan vazquez al correo : marcegv15@gmail.com del folio eqiCt5PvGl
 Victor Manuel Tejeda Bernal al correo : amusydan@live.com.mx del folio 9ClhpeWXgq
 IGNACIO HERNANDEZ PEREZ al correo : sandrailil2002@hotmail.com del folio hRiJOplWXS
 Susana Barrag al correo : yaocoatl09@Gmail.com del folio P62F7dxcne
 Braulio Valera Hernandez al correo : delicias.del.valle@hotmail.com del folio p4DgYxOFW3
 Luz Mar al correo : azulcanicas@yahoo.com.mx del folio QOhvpdlKCu
 Alejandra S al correo : mafalda_af_1@hotmail.com del folio yKURJgDMd1
 Cynthia Villar Serrano al correo : cantera22@hotmail.com del folio f43mpCRN6L
 FERNANDO JIMENEZ JIMENEZ al correo : fjimenez@blojima.com.mx del folio U3XucsNdIR
 Yurey davila gomez al correo : anngvenegas21@gmail.com del folio 96pJBQHGK2
 Patricia Lopez Cabrera al correo : lanegramora@hotmail.es del folio ZNMsEQeLyd
 Benjamin Alfaro Rosario al correo : norbenonix@hotmail.com del folio EdFwMXJplI
 Javier Obregon Hernandez al correo : cckambalache@yahoo.com.mx del folio aOngGlqk8c
 SERGIO ALONSO DELGADO SEDANO al correo : sergioalonso73@hotmail.com del folio jhHq8b3xAS
 GUADALUPE SILVERIO TORRES al correo : slupissnoopy@hotmail.com del folio AImOlcpnEf
 julia carrillo enriquez al correo : e.dlcc@hotmail.com del folio PrHKwG9Zy2
 LILIA VICENTE DE LA CRUZ al correo : vicentedelacruzlilia@hotmail.c del folio bhqwFvCs96
 V al correo : carrasco.victor2000@gmail.com del folio U0eGO5YoWK
 PAZ DIAZ VARGAS al correo : nonantzinmx@gmail.com del folio 4v0DIW1QnG
 Griselda Tihui Campos Ortiz al correo : tihuicampos@gmail.com del folio 1OM3Rr8qpE
 RAFAELA SANCHEZ LOPEZ al correo : salorafy@hotmail.com del folio FlMrGwBLzO
 Patricia Aparicio Figueroa al correo : pafceramica@hotmail.com del folio CJiZN8qosu
 Anabel Avila Mata al correo : nextiatlahulli@hotmail.es del folio wXPpZEaKNQ
 Selene Lagunas Gonz al correo : selenelags@gmail.com del folio E7196JISlR
 Miguel Valeria Ascencion al correo : mikelvaleria19@gmail.com del folio Iftp28ZDrA
 Maria del Rosario Cardoso al correo : ynleyansa@gmail.com del folio T0OuMng71N
 Dar al correo : dglezmor@gmail.com del folio LPe9AcN6oU
 Pascuala L al correo : satbopascuala78@hotmail.com del folio S3PXs1ARln
 Pascuala Hern al correo : bordadosaclum@hotmail.com del folio 1MjX5wavoL
 Karime Vivanco Torres al correo : verdeoliva6@hotmail.com del folio 0SDWEnJh3k
 Yolanda Esther Ramirez Guerrero al correo : chilmoli.salsas@yahoo.com.mx del folio TCzngYDUuQ
 LETICIA ESQUIVEL HERNANDEZ al correo : leticiia.esquivel.hdz@hotmail. del folio zbdCWEJpD1
 Heriberto Gonzalez Padilla al correo : luciogonzalez882@gmail.com del folio x9aSocwiO6
 Cristeta Lopez Cristobal al correo : diegobene@hotmail.com del folio 91uQcYfvP2
 H al correo : hecsanflo@hotmail.com del folio Ix9vQ6gOao
 alberta cruz sanchez al correo : bcruz.arts.@gmail.com del folio gPlCdq4cfT
 dulce maria cruz sanchez al correo : antonioseguramon8@gmail.com del folio 9x6jy2mV7p
 Ma Mercedes Sifuentes Valenzuela al correo : blancosdemanta@hotmail.com del folio QOcFnkzLKX
 Maria de Jesus  Valdovinos Valdovinos al correo : maxfs@hotmail.com del folio SLgAPqGo07
 Beatriz Guadarrama Reyes al correo : bettyek7@hotmail.com del folio bEnQf7Hl6K
 Diana Atenea Castro Villasana al correo : surip_22@hotmail.com del folio EwuWBDMZjX
 carmela gonzalez octamendez al correo : car5nahuiopan@hotmail.com del folio sOUbkGPR1p
 Xochitl Martinez Alvarez al correo : chochy.maax@gmail.com del folio wItpTC4riH
 Oliva Reyes Vera al correo : oguzman@atosa.com.mx del folio sR3ZO29vcX
  al correo :  del folio 5lXAxhuEpr
 Anel Flores Rodriguez al correo : anelita2016@hotmail.com del folio JS7D6GxoRl
 Dante David Varon Flores al correo : dan.dav.esm@hotmail.com del folio Gpf7LhTxtb
 Wilber Agust al correo : mictlan1903@hotmail.com del folio FBDoxjedYU
 Jose Flaviano Lino al correo : jos.flaviano@yahoo.com.mx del folio GidyNfXxq8
 Alejandro avila cienega al correo : avalentino196@gmail.com del folio JVQaGCDsbn
 Nayeli Tierrafria Vazquez al correo : nellytv90@gmail.com del folio 9w5Zk6BE7m
 Olimpia Araceli Juarez Romero al correo : calzada_1107@hotmail.com del folio Wr0dZeCuJK
 LETICIA ESQUIVEL HDZ al correo : leticia.esquivel.hdz@hotmail.c del folio 19VZ3yI6FH
 FAUSTO MOLINA PATI al correo : increacionarte@gmail.com del folio GUcKiHyesx
 Feliciano Alegre Ignacio al correo : f.alegre02@hotmail.com del folio 0pBCgh3X9b
 Bernarda Celestino Sandoval al correo : k01zacnite@hotmail.com del folio jPfav973yX
 Maria Felix Quijano al correo : agatrast14@hotmail.com del folio WhTO0tY3rH
 MIGUEL ANGEL MOLINA PATI al correo : molina.ajusco@yahoo.com.mx del folio NOXE3zl7tC
 Graciela Mu al correo : gracielamu477@gmail.com del folio 5V7ybMBOzm
 Raquel Fern al correo : rakelin111@gmail.com del folio 4jYpUQoEKe
 Fernando Jim al correo : fernando@eltulerestaurante.com del folio PZSerNpOEk
 Valeria rios flores al correo : prinzez.2013@hotmail.com del folio kymfNaC2zL
 Angel S al correo : issa160980@hotmail.com del folio 1rLyNXxcCh
 Leticia Becerril Gonzalez al correo : artemoaya@hotmail.com del folio Ib3z9YxTE5
 Martha Elena F al correo : platanizarindani@hotmail.com del folio qkzUmXu16L
 Zureyma Xolalpa Mateo al correo : xamyeruz@yahoo.com.mx del folio Z8sX2hgxOm
 Edgar T al correo : xipe11@hotmail.com del folio UDSWePTYhv
 Gerardo Garc al correo : lourdes_arbol@hotmail.com del folio mbdRexB96A
 Diana Carolina Puente Aguirre al correo : fantino@live.com.mx del folio ANWcyB31YL
 Gaspar Garcia Garcia al correo : xkaldua@hotmail.com del folio XN0I2egD8h
 Socrates Raul Galicia Serralde al correo : socra0001@hotmail.com del folio eCsnW3rzjN
 Iv al correo : espiromaniaco@gmail.com del folio 1czdLITCRa
 gustavo Martinez Diego al correo : peeweenet@hotmail.com del folio qe7uaMQGF6
 BERTHA HERNANDEZ GASPAR al correo : apiarioatotolco@hotmail.com del folio tSmGAg085j
 Colectivo Yolcuu  al correo : yolcuusuljaa@hotmail.com del folio E15IYB3PoS
 Gloria Quezada Diaz al correo : cafe_88@live.com.mx del folio pW7tzFaMyi
 Sonia Ayala Garcia al correo : parchesitos@gmail.com del folio OFRhLC8wQH
 Dolores al correo : doloresmdz123@outlook.com del folio uOxX4jpVWN
 ISAAC SARMIENTO TRUJILLO al correo : isarmientotrujillo@gmail.com del folio Mb5wcH2LQn
 Maria Cristina Jimenez Martinez al correo : xochi_arte@hotmail.com del folio h10zbnG4sJ
 Sebastian Moreno P al correo : lazulibeach@gmail.com del folio qETwBZLbPh
